CMS15	AAATACTTAAAGGTTCCCAGA	TTGTAAACTAAAGCCAGAAAG
YWLL09	AAGTCTAGGAACCGGAATGC	AGTCAATCTACACTCCTTGC
CVRL07	AATACCCTAGTTGAAGCTCTGTCCT	GAGTGCCTTTATAAATATGGGTCTG
VOLP03	AGACGGTTGGGAAGGTGGTA	CGACAGCAAGGCACAGGA
YWLL08	ATCAAGTTTGAGGTGCTTTCC	CCATGGCATTGTGTTGAAGAC
CMS121	CAAGAGAACTGGTGAGGATTTTC	AGTTGATAAAAATACAGCTGGAAAG
VOLP08	CCATTCACCCCATCTCTC	TCGCCAGTGACCTTATTTAGA
CVRL05	CCTTGGACCTCCTTGCTCTG	GCCACTGGTCCCTGTCATT
YWLL44	CTCAACAATGCTAGACCTTGG	GAGAACACAGGCTGGTGAATA
VOLP10	CTTTCTCCTTTCCTCCCTACT	CGTCCACTTCCTTCATTTC
CVRL01	GAAGAGGTTGGGGCACTAC	CAGGCAGATATCCATTGAA
YWLL38	GGCCTAAATCCTACTAGAC	CCTCTCACTCTTGTTCTCCTC
VOLP32	GTGATCGGAATGGCTTGAAA	CAGCGAGCACCTGAAAGAA
LCA66	GTGCAGCGTCCAAATAGTCA	CCAGCATCGTCCAGTATTCA
CMS13	TAGCCTGACTCTATCCATTTCTC	ATTATTTGGAATTCAACTGTAAGG
CMS17	TATAAAGGATCACTGCCTTC	AAAATGAACCTCCATAAAGTTAG
CMS9	TGCTTTAGACGACTTTTACTTTAC	ATTTCACTTTCTTCATACTTGTGAT
CVRL02	TGTCACAAATGGCAAGAT	AGTGTACGTAGCAGCATTATTT
VOLP67	TTAGAGGGTCTATCCAGTTTC	TGGACCTAAAAGAGTGGAC
CMS50	TTTATAGTCAGAGAGAGTGCTG	TGTAGGGTTCATTGTAACA
CVRL06	TTTTAAAAATTCTGACCAGGAGTCTG	CATAATAGCCAAAACATGGAAACAAC